#####################
#...................#
#...................#
#...................#
#...................#
#...................#
#...................#
#...................#
#...................#
#...................#
#...................#
#..................G#
#####################