#######
#.....#
#.....#
#.....#
#.....#
#.....#
###/###