###/####
#......#
#......#
#......#
#......#
#......#
#......#
#####/##