#####################
#...................#
#...................#
#.............#######
#.............#
#.............#######
#...................#
#...................#
#...................#
#...................#
#...................#
#..................G#
#####################