                                                                                                                                                      
                                                                                                                                                      
                                                                                                                                                      
                                                                                                                                                      
                                                                                                                                                      
                                                                                                                                                      
                                                                                                                                                      
                                                                                                                                                      
                                                                                                                                                      
                                                                                                                                                      
                                                                                                                                                      
                                                                                                                                                      
                                                                                                                                                      
                                                                                                                                                      
                                                                                                                                                      
                                                                                                                                                      
                                                                                                                                                      
                                                                                                                                                      
                                                                                                                                                      
                                                                                                                                                      
                                                                                                                                                      
                                                                                                                                                      
                                                                                                                                                      
                                                                                                                                                      
                                                                                                                                                      
                                                                                                                                                      
                                                                                                                                                      
                                                                                                                                                      
                                                                                                                                                      
                                                                                                                                                      
                                                                                                                                                      
                                                                                                                                                      
                                                                                                                                                      
                                                                                                                                                      
                                                                                                                                                      
                                     ###########                                                                                                      
             ##############          #.........#                                                                                                      
             #............#          #.........#              ##############                                                                          
             #............#          #.........#              #............#                                                                          
             #............#          #.........#              #............#                                                                          
             #............////////////.........////////////////............#                            #############                                 
             #............#          #.........#              #............#                            #...........#                                 
             #............#          #.........#              #............#                            #...........#                                 
             #............#          #.........#              #######/######                            #...........#                                 
             ##############          ###########                     /                                  #...........///////////////////               
                                                                     /          ##############          #...........#                 /               
                                         #############               /          #............#          #...........#                 /               
                  ##############         #...........#               /          #............#          #############            #####/#####          
                  #............#         #...........#               /          #............#                                   #.........#          
                  #............#         #...........#               /          #............/////////////////                   #.........#          
                  #............#         #...........#               /          #............#               /                   #.........#          
                  #............///////////.........../////////////////          #............#               /                   #.........#          
                  #............#         #...........#               /          #............#               /                   #.........#          
                  #............#         #...........#               /          ##############         ######/#####              #.........#          
                  #............#         #...........#               /                                 #..........#              #.........#          
                  #######/######         #############        #######/######                           #..........#              #####/#####          
                         /                                    #............#                           #..........#                   /               
                         /                                    #............#                           #..........#                   /               
                         /                                    #............#                           #..........#                   /               
                         /                                    #............#                           #..........#                   /               
                         /                      ///////////////............#                           #..........#                   /               
     ##############      /                      /             #............#     ###############       #..........#                   /               
     #............#      /                      /             #............#     #.............#       ######/#####                   /               
     #............#      /                      /             #............#     #.............#             /                        /               
     #............#  ####/##########     #######/#######      ##############     #.............#             /                        /               
     #............#  #.............#     #.............#                         #.............#       ######/########                /               
     #............////.............#     #.............#                         #.............#       #.............#                /               
     #............#  #.............#     #.............#                         #.............#       #.............#         #######/#######        
     #............#  #.............///////............./////////////////////     #######/#######       #.............#         #.............#        
     #............#  #.............#     #.............#                   /            /              #.............#         #.............#        
     ##############  #.............#     #.............#                   /            /              #.............///////////.............#        
                     ###############     #######/#######                   /            /              #.............#         #.............#        
                                                /                     #####/####        /              #.............#         #.............#        
                                                /                     #$$$$$$$$#        /              #.............#         ###############        
                                                /                     #$$$$$$$$#        /              ######/########                                
                                       #########/####                 #$$$$$$$$#        /                    /                                        
                                       #............#                 #$$$$$$$$#        /             #######/######                                  
                                       #............#                 #$$$$$$$$#        /             #............#                                  
                                       #............#                 #####/####        /             #............#                                  
                                       #............#                      /            ///////////////............#                                  
      ###############                  #............#                      /            /             #............#                                  
      #.............#                  #............#                      /            /             #............#                                  
      #.............#                  #............#                      /            /             #######/######                                  
      #.............///////////////////#######/#/####                      /            /                    /                                        
      #.............#                 /       / /                          /            /                    /                                        
      #.............#                 /       / /                          /       #####/####                /                                        
      #######/#######                 /       / /      ##############      /       #........#                /                                        
             /                        /       / /      #............#      /       #........#                /                                        
        #####/#######           ######/###### / /      #............#      /       #........#                /                                        
        #...........#           #...........# / /      #............#      /       #........#                /                                        
        #...........#           #...........# / /      #............////////////////........#                /                                        
        #.........../////////////.........../////      #............#      /       #........#                /                                        
        #...........#           #...........# /        #............#      /       #........#                /                                        
        #...........#           #...........# /        #............#      /       #........#                /                                        
        #####/#######           ############# /        ##############      /       #####/####                /                                        
             /                                /                            /            /                    /                                        
             /                         #######/#######                     /            /                    /                                        
             /                         #.............#                #####/#####       /                    /                                        
             /                         #.............#                #.........#       /                    /                                        
       ######/######                   #.............#                #.........#       /               #####/#####                                   
       #...........#                   #.............//////////////////.........#       /               #.........#                                   
       #...........#                   #.............#                #.........#       /               #.........#                                   
       #...........#                   #.............#                #.........#       /               #.........#                                   
       #...........#                   #.............#                #####/#####       /               #.........#                                   
       #...........#                   ###############                     /            /  ##########   #.........#                                   
       #...........#                                                       /            /  #........#   #.........#                                   
       #...........#                          ###########                  /            /  #........#   #.........#                                   
       #############                          #.........#              ####/#####       /  #........#   #.........#                                   
                                              #.........#              #........#       /  #........#   #####/#####                                   
                                              #.........#              #........#       /  #........#        /                                        
                                              #.........#              #........#       /  #........#        /                                        
                                              #.........////////////////......../////////  #........#        /                                        
                                              #.........#              #........#          #####/####        /                                        
                                              #.........# ############ #........#               /            /                                        
                                              #.........# #..........# #........#               /            /                                        
                                              #####/##### #..........# ####/#####               /            /                                        
                                                   /      #..........///////                    /            /                                        
                                                   /      #..........#                          /            /                                        
                                                   /      #..........#                          /            /                                        
                                                   /      ############                          /            /                                        
                                                   /                                            /            /                                        
                                                   /                                            /            /                                        
                                                   /                                            /            /                                        
                                                   /                                            /            /                                        
                                                   /            ###########                     /            /                                        
                                                   /            #.........#                #####/#####       /                                        
   ############                 ###############    /            #.........#                #.........#       /                                        
   #EEEEEEEEEE#                 #.............#    /            #.........#                #.........#       /                                        
   #EEEEEEEEEE#                 #.............#    /            #.........#                #.........#       /                                        
   #EEEEEEEEEE#                 #.............#    /            #.........//////////////////........./////////                                        
   #EEEEEEEEEE///////////////////.............//////            #.........#                #.........#                                                
   #EEEEEEEEEE#                 #.............#                 #.........#                #.........#                                                
   #EEEEEEEEEE#                 #.............#                 #.........#                #.........#                                                
   ############                 ###############                 ###########                ###########                                                
                                                                                                                                                      
                                                                                                                                                      
                                                                                                                                                      
                                                                                                                                                      
                                                                                                                                                      
                                                                                                                                                      
                                                                                                                                                      
                                                                                                                                                      
                                                                                                                                                      
                                                                                                                                                      
                                                                                                                                                      
                                                                                                                                                      
                                                                                                                                                      
                                                                                                                                                      
                                                                                                                                                      
                                                                                                                                                      
